GGGGGGGGGGGGGGGGGGGGGGGGGGGGGGGGGGGGGGGGGGGGGGGGGG 
GGGGGGGGGGGGGGGGGGGGGGGGGGGGGGGGGGGGGGGGGGGGGGGGGG 
GGGGGGGGGGGGGGGGGGGGGGGGGGGGGGGGGGGGGGGGGGGGGGGGGG 
GGGGGGGGGGGGGGGGGGGGGGGGGGGGGGGGGGGGGGGGGGGGGGGGGG 
GGGGGGGGGGGGGGGGGGGGGGGGGGGGGGGGGGGGGGGGGGGGGGGGGG 
GGGGGGGGGGGGGGGGGGGGGGGGGGGGGGGGGGGGGGGGGGGGGGGGGG 
GGGGGGGGGGGGGGGGGGGGGGGRRRGGGGGGGGGGGGGGGGGGGGGGGG 
GGGGGGGGGGGGGGGGGGGGGGGGRGGGGGGGGGGGGGGGGGGGGGGGGG 
GGGGGGGGGGGGGGGGGGGGGGGGRGGGGGGGGGGGGGGGGGGGGGGGGG 
GGGGGGGGGGGGGGGGGGGGGGGGRGGGGGGGGGGGGGGGGGGGGGGGGG 
GGGGGGGGGGGGGGWWWGGGGRRRRGGGGGGGGGGGGGGGGGGGGGGGGG 
GGGGGGGGGGGGGWWWWWGGGGGGGGGGGGGGGGGGGGGGGGGGGGGGGG 
GGGGGGGGGGGGWWWWWWWGGGGGGGGGGGGGGGGGGGGGGGGGGGGGGG 
GGGGGGGGGGGWWWWWWWWWGGGGGGGGGGGGGGGGGGGGGGGGGGGGGG 
GGGGGGGGGGWWWWWWWWWWWGGGGGGGGGGGGGGGGGGGGGGGGGGGGG 
GGGGGGGGGGWWWWWWWWWWWGGGGGGGGGGGGGGGGGGGGGGGGGGGGG 
GGGGGGGGGGWWWWWWWWWWWGGGGGGGGGGGGGGGGGGGGGGGGGGGGG 
GGGGGGGGGGGWWWWWWWWWGGGGGGGGGGGGGGGGGGGGGGGGGGGGGG 
GGGGGGGGGGGGWWWWWWWGGGGGGGGGGGGGGGGGGGGGGGGGGGGGGG 
GGGGGGGGGGGGGWWWWWGGGGGGGGGGGGGGGGGGGGGGGGGGGGGGGG 
GGGGGGGGGGGGGGWWWGGGGGGGGGGGGGGGGGGGGGGGGGGGGGGGGG 
GGGGGGGGGGGGGGGGGGGGGGGGGGGGGGGGGGGGGGGGGGGGGGGGGG 
GGGGGGGGGGGGGGGGGGGGGGGGGGGGGGGGGGGGGGGGGGGGGGGGGG 
GGGGGGGGGGGGGGGGGGGGGGGGGGGGGGGGGGGGGGGGGGGGGGGGGG 
GGGGGGGGGGGGGGGGGGGGGGGGGGGGGGGGGGGGGGGGGGGGGGGGGG 
GGGGGGGGGGGGGGGGGGGGGGGGGGGGGGGGGGGGGGGGGGGGGGGGGG 
GGGGGGGGRRRRGGGGGGGGGGGGGGGGGGGGGGGGGGGGGGGGGGGGGG 
GGGGGGGGRGGRRRGGGGGGGGGGGGGGGGGGGGGGGGGGGGGGGGGGGG 
GGGGGGGGRRRGGRGGGGGGGGGGGGGGGGGGGGGGGGGGGGGGGGGGGG 
GGGGGGGGGGRGGRRGGGGGGGGGGGGGGGGGGGGGGGGGGGGGGGGGGG 
GGGGGGGRRRRGGRRRRRRRRRRRRGGGGGGGGGGGGGGGGGGGGGGGGG 
GGGGGGGRRRRGGRGGRGGGGGGGRGGGGGGGGGGGGGGGGGGGGGGGGG 
GGGGGGRRGGRGGRRGWWWGWWGGRGGGGGGGGGGGGGGGGGGGGGGGGG 
GGGGGGRRRRRGGGRRWWWWWWGGRGGGGGGGGGGGGGGGGGGGGGGGGG 
GGGGGGGGGGRGGGRRWWWWWWWGRGGGGGGGGGGGGGGGGGGGGGGGGG 
GGGGGGGGGGRGGRRRGWWWWWWWRGGGGGGGGGGGGGGGGGGGGGGGGG 
GGGGGGGGGRRGRRGGGWWWWWWWRGGGGGGGGGGGGGGGGGGGGGGGGG 
GGGGGGGGGRGGRGGGWWWWWWWWRGGGGGGGGGGGGGGGGGGGGGGGGG 
GGGGGGGGGRGGRGGGWWWWWWGGRGGGGGGGGGGGGGGGGGGGGGGGGG 
GGGGGGGGGRRRRGGGGGWWWWGGRGGGGGGGGGGGGGGGGGGGGGGGGG 
GGGGGGGGGGGGRGGGGGGGGGGGRGGGGGGGGGGGGGGGGGGGGGGGGG 
GGGGGGGGGGGGRRRRRRRRRRRRRGGGGGGGGGGGGGGGGGGGGGGGGG 
GGGGGGGGGGGGGGGGGGGGGGGGGGGGGGGGGGGGGGGGGGGGGGGGGG 
GGGGGGGGGGGGGGGGGGGGGGGGGGGGGGGGGGGGGGGGGGGGGGGGGG 
GGGGGGGGGGGGGGGGGGGGGGGGGGGGGGGGGGGGGGGGGGGGGGGGGG 
GGGGGGGGGGGGGGGGGGGGGGGGGGGGGGGGGGGGGGGGGGGGGGGGGG 
GGGGGGGGGGGGGGGGGGGGGGGGGGGGGGGGGGGGGGGGGGGGGGGGGG 
GGGGGGGGGGGGGGGGGGGGGGGGGGGGGGGGGGGGGGGGGGGGGGGGGG 
GGGGGGGGGGGGGGGGGGGGGGGGGGGGGGGGGGGGGGGGGGGGGGGGGG
GGGGGGGGGGGGGGGGGGGGGGGGGGGGGGGGGGGGGGGGGGGGGGGGGG
