B() B B B B B B B B B B B B B B B B B B B
B G B W W W W B B B B R R R R R R R R B
B G B W W W W B B B B B B B B B B B R B
B G B B B W W B B B B B B B B B B B R B
B G G B B W W B B B B B B B B B B B R B
B B G G B W W B B B B B B B B B B R R B
B B B G B W W W W B B B B B B B B R B B
B B B B B W W W W B B B B B B B R R B B
B B B B B W W W W B B B B B B B R B B B
B B B B B W W W W B B B B B B B R B B B
B B B B B B B B B B B B B B B B R B B B
B B B B B B B B B B B B B B B B B B B B
B B B B B B B B B B B B B B B B B B B B
B B B B B B B B B B B B B B B B B B B B
B B B B B B B B B B B B B B B B B B B B
B B B B B B B B B B B B B B B B B B B B
B B B B B B B B B B B B B B B B B B B B
B B B B B B B B B B B B B B B B B B B B
B B B B B B B B B B B B B B B B B B B B
B B B B B B B B B B B B B B B B B B B B 